11111111111111111111111111111111111111111111111111111111111111111111111111111111111111111111111111
1P0000000000000000000000000000000000000V0000000000000000000000000000000000000000000000000000000001
10000000000000000000000000C0000000000000000000000000000000C0000000000000000000000000000000C0000001
10000000000000000000000000000000000000000000000000000000000000000000000000000000000000000000000001
10000C0000000000000000000000000000000C0000000000000000000000000000000C0000000000000000000000000001
10000000000000000000000000000000000000000000000000000000000000000000000000000000000000000000000001
10000000000000000000000000000000000000000000000000000000000000000000000000000000000000000000000001
10000000000000000000000000000000000000000000000000000000000000000000000000000000000000000000000001
100000000C0000000000000000000000000000000C0000000000000000000000000000000C000000000000000000000001
10000000000000000000000000000000000000000000000000000000000000000000000000000000000000000000000001
10000000000000000000000000000000000000000000000000000000000000000000000000000000000000000000000001
10000000000000000000000000000000000000000000000000000000000000000000000000000000000000000000000001
1000000000000000000C0000000000000000000000000000000C0000000000000000000000000000000C00000000000001
10000000000000000000000000000000000000000000000000000000000000000000000000000000000000000000000001
10000000000000000000000000000000000000000000000000000000000000000000000000000000000000000000000001
10000000000000000000000000000C0000000000000000000000000000000C0000000000000000000000000000000C0001
10000000000000000000000000000000000000000000000000000000000000000000000000000000000000000000000001
1000000C0000000000000000000000000000000C0000000000000000000000000000000C00000000000000000000000001
10000000V00000000000000000000000000000000000000000000000000000000000000000000000000000000VV00000E1
11111111111111111111111111111111111111111111111111111111111111111111111111111111111111111111111111