1111111111111111111111111111111111
1000V0000000000C00V00C0000000000E1
1010010100100000101001000000010101
1010010010101010001001000000010101
1P0000000CV0C000000000000V000000C1
1111111111111111111111111111111111