111111111111111111111
1P0000000C000000000E1
111011110111100000011
111011110111111111011
111011110111111111011
111000C0V11110C000011
111111110111101111111
111111110111101111111
11111111V1111000C0V11
111111111111111111111