111111111
100C000E1
1P0000001
100C00001
111111111