111111111
100C000E1
1P000V001
100C00001
111111111