111111111
100C000E1
1P000V001
1V0C00001
111111111